{
    "levels": [
        {
            "id": 0,
            "layout": [
                1, 1, 1, 1, 1, 1, 1, 1, 1, 1, 1, 1, 1, 1, 1, 1, 1, 1, 1, 1, 1,
                1, 1, 1, 1, 1, 1, 1, 1, 3, 4, 4, 4, 4, 4, 4, 4, 4, 4, 4, 4, 4,
                4, 4, 4, 4, 4, 4, 4, 4, 4, 4, 4, 4, 3, 1, 1, 1, 1, 1, 1, 1, 1,
                1, 1, 1, 1, 1, 1, 1, 1, 1, 1, 1, 1, 1, 1, 1, 1, 4, 1, 1, 1, 1,
                1, 1, 1, 1, 1, 1, 1, 1, 1, 1, 1, 1, 1, 1, 1, 1, 1, 1, 1, 1, 1,
                1, 1, 4, 1, 1, 1, 1, 1, 1, 1, 1, 1, 1, 1, 1, 1, 1, 1, 1, 1, 1,
                1, 1, 1, 1, 1, 1, 1, 1, 1, 0, 1, 1, 1, 1, 1, 0, 0, 0, 1, 0, 0,
                0, 1, 0, 1, 0, 0, 0, 1, 0, 0, 0, 1, 0, 1, 0, 4, 0, 4, 0, 0, 0,
                1, 1, 1, 0, 1, 0, 1, 1, 1, 0, 1, 0, 1, 1, 1, 0, 1, 0, 1, 0, 1,
                0, 1, 1, 1, 0, 1, 1, 1, 1, 1, 0, 1, 0, 0, 1, 1, 0, 1, 0, 0, 0,
                1, 0, 1, 0, 1, 0, 0, 0, 1, 1, 1, 0, 0, 0, 1, 0, 1, 0, 1, 0, 1,
                1, 1, 0, 1, 1, 1, 0, 1, 0, 1, 0, 1, 0, 0, 0, 1, 1, 1, 1, 1, 0,
                1, 0, 0, 4, 4, 0, 0, 0, 1, 0, 4, 0, 0, 0, 1, 0, 0, 0, 4, 0, 1,
                0, 1, 1, 1, 0, 0, 0, 1, 1, 1, 1, 4, 1, 1, 1, 1, 4, 1, 1, 4, 1,
                1, 4, 1, 1, 4, 1, 1, 1, 1, 1, 1, 1, 4, 1, 1, 1, 1, 1, 4, 1, 1,
                1, 1, 4, 1, 2, 2, 2, 2, 2, 2, 1, 4, 1, 1, 1, 1, 1, 1, 1, 4, 1,
                1, 1, 1, 1, 4, 1, 1, 1, 1, 4, 1, 2, 2, 2, 2, 2, 2, 1, 4, 1, 1,
                1, 1, 1, 1, 1, 4, 1, 4, 4, 4, 4, 4, 4, 4, 4, 4, 4, 1, 2, 2, 2,
                2, 2, 2, 1, 4, 4, 4, 4, 4, 4, 4, 4, 4, 4, 1, 4, 1, 1, 1, 1, 4,
                1, 1, 4, 1, 1, 1, 1, 1, 1, 1, 1, 4, 1, 1, 4, 1, 1, 1, 1, 4, 1,
                1, 4, 1, 1, 1, 1, 4, 1, 1, 4, 4, 4, 4, 4, 4, 4, 4, 4, 4, 1, 1,
                4, 1, 1, 1, 1, 4, 1, 1, 4, 1, 1, 1, 1, 4, 1, 1, 4, 1, 1, 1, 4,
                1, 1, 1, 1, 4, 1, 1, 4, 1, 1, 1, 1, 4, 1, 1, 0, 0, 1, 1, 1, 0,
                1, 1, 0, 0, 1, 1, 4, 1, 1, 0, 1, 0, 1, 1, 0, 1, 1, 0, 1, 0, 1,
                1, 0, 1, 0, 4, 0, 1, 0, 1, 0, 1, 1, 1, 4, 1, 1, 0, 0, 0, 1, 0,
                1, 0, 1, 0, 1, 0, 1, 1, 0, 0, 1, 1, 0, 0, 0, 1, 0, 1, 1, 0, 0,
                0, 1, 0, 0, 0, 1, 0, 0, 0, 1, 0, 0, 0, 1, 1, 0, 1, 1, 1, 0, 1,
                0, 1, 0, 1, 1, 1, 1, 1, 1, 0, 1, 0, 1, 0, 1, 0, 1, 0, 0, 0, 1,
                1, 0, 1, 1, 1, 0, 1, 0, 4, 0, 0, 1, 1, 1, 1, 1, 0, 1, 0, 4, 0,
                1, 0, 4, 0, 1, 0, 1, 1, 1, 1, 1, 1, 1, 1, 1, 4, 1, 1, 1, 1, 1,
                1, 1, 1, 1, 1, 1, 1, 1, 1, 1, 1, 1, 1, 1, 1, 1, 1, 1, 1, 1, 1,
                1, 4, 1, 1, 1, 1, 1, 1, 1, 1, 1, 1, 1, 1, 1, 1, 1, 1, 1, 1, 1,
                1, 1, 1, 1, 1, 1, 1, 1, 4, 1, 1, 1, 1, 1, 1, 1, 1, 1, 1, 1, 1,
                1, 1, 1, 1, 1, 1, 1, 1, 1, 1, 1, 1, 1, 1, 1, 4, 1, 1, 1, 1, 1,
                1, 1, 1, 1, 1, 1, 1, 1, 1, 1, 1, 1, 1, 1, 1, 3, 4, 4, 4, 4, 4,
                4, 4, 4, 4, 4, 4, 4, 4, 4, 4, 4, 4, 4, 4, 4, 4, 4, 4, 4, 3, 1,
                1, 1, 1, 1, 1, 1, 1, 1, 1, 1, 1, 1, 1, 1, 1, 1, 1, 1, 1, 1, 1,
                1, 1, 1, 1, 1, 1, 1
            ],
            "pacStart": 489,
            "ghostsMeta": [
                { "className": "blinky", "startIndex": 348, "speed": 100 },
                { "className": "pinky", "startIndex": 376, "speed": 150 },
                { "className": "inky", "startIndex": 351, "speed": 200 },
                { "className": "clyde", "startIndex": 379, "speed": 250 }
            ]
        },
        {
            "id": 1,
            "layout": [
                1, 1, 1, 1, 1, 1, 1, 1, 1, 1, 1, 1, 1, 1, 1, 1, 1, 1, 1, 1, 1,
                1, 1, 1, 1, 1, 1, 1, 1, 0, 0, 0, 0, 0, 0, 0, 0, 0, 0, 0, 0, 1,
                1, 0, 0, 0, 0, 0, 0, 0, 0, 0, 0, 0, 0, 1, 1, 0, 1, 1, 1, 1, 0,
                1, 1, 1, 1, 1, 0, 1, 1, 0, 1, 1, 1, 1, 1, 0, 1, 1, 1, 1, 0, 1,
                1, 3, 1, 1, 1, 1, 0, 1, 1, 1, 1, 1, 0, 1, 1, 0, 1, 1, 1, 1, 1,
                0, 1, 1, 1, 1, 3, 1, 1, 0, 1, 1, 1, 1, 0, 1, 1, 1, 1, 1, 0, 1,
                1, 0, 1, 1, 1, 1, 1, 0, 1, 1, 1, 1, 0, 1, 1, 0, 0, 0, 0, 0, 0,
                0, 0, 0, 0, 0, 0, 0, 0, 0, 0, 0, 0, 0, 0, 0, 0, 0, 0, 0, 0, 1,
                1, 0, 1, 1, 1, 1, 0, 1, 1, 1, 1, 1, 1, 1, 1, 1, 1, 1, 1, 1, 1,
                0, 1, 1, 1, 1, 0, 1, 1, 0, 1, 1, 1, 1, 0, 1, 1, 1, 1, 1, 1, 1,
                1, 1, 1, 1, 1, 1, 1, 0, 1, 1, 1, 1, 0, 1, 1, 0, 0, 0, 0, 0, 0,
                0, 0, 0, 0, 0, 0, 1, 1, 0, 0, 0, 0, 0, 0, 0, 0, 0, 0, 0, 0, 1,
                1, 1, 1, 1, 1, 1, 0, 1, 1, 1, 1, 1, 0, 1, 1, 0, 1, 1, 1, 1, 1,
                0, 1, 1, 1, 1, 1, 1, 1, 1, 1, 1, 1, 1, 0, 1, 1, 4, 4, 4, 4, 4,
                4, 4, 4, 4, 4, 1, 1, 0, 1, 1, 1, 1, 1, 1, 1, 1, 1, 1, 1, 1, 0,
                1, 1, 4, 1, 1, 1, 2, 2, 1, 1, 1, 4, 1, 1, 0, 1, 1, 1, 1, 1, 1,
                1, 1, 1, 1, 1, 1, 0, 1, 1, 4, 1, 2, 2, 2, 2, 2, 2, 1, 4, 1, 1,
                0, 1, 1, 1, 1, 1, 1, 4, 4, 4, 4, 4, 4, 0, 0, 0, 4, 1, 2, 2, 2,
                2, 2, 2, 1, 4, 0, 0, 0, 4, 4, 4, 4, 4, 4, 1, 1, 1, 1, 1, 1, 0,
                1, 1, 4, 1, 2, 2, 2, 2, 2, 2, 1, 4, 1, 1, 0, 1, 1, 1, 1, 1, 1,
                1, 1, 1, 1, 1, 1, 0, 1, 1, 4, 1, 1, 1, 1, 1, 1, 1, 1, 4, 1, 1,
                0, 1, 1, 1, 1, 1, 1, 1, 1, 1, 1, 1, 1, 0, 1, 1, 4, 1, 1, 1, 1,
                1, 1, 1, 1, 4, 1, 1, 0, 1, 1, 1, 1, 1, 1, 1, 1, 1, 1, 1, 1, 0,
                1, 1, 4, 1, 1, 1, 1, 1, 1, 1, 1, 4, 1, 1, 0, 1, 1, 1, 1, 1, 1,
                1, 0, 0, 0, 0, 0, 0, 0, 0, 4, 4, 4, 4, 4, 4, 4, 4, 4, 4, 0, 0,
                0, 0, 0, 0, 0, 0, 1, 1, 0, 1, 1, 1, 1, 0, 1, 1, 1, 1, 1, 0, 1,
                1, 0, 1, 1, 1, 1, 1, 0, 1, 1, 1, 1, 0, 1, 1, 0, 1, 1, 1, 1, 0,
                1, 1, 1, 1, 1, 0, 1, 1, 0, 1, 1, 1, 1, 1, 0, 1, 1, 1, 1, 0, 1,
                1, 3, 0, 0, 1, 1, 0, 0, 0, 0, 0, 0, 0, 0, 0, 0, 0, 0, 0, 0, 0,
                0, 1, 1, 0, 0, 3, 1, 1, 1, 1, 0, 1, 1, 0, 1, 1, 0, 1, 1, 1, 1,
                1, 1, 1, 1, 0, 1, 1, 0, 1, 1, 0, 1, 1, 1, 1, 1, 1, 0, 1, 1, 0,
                1, 1, 0, 1, 1, 1, 1, 1, 1, 1, 1, 0, 1, 1, 0, 1, 1, 0, 1, 1, 1,
                1, 0, 0, 0, 0, 0, 0, 1, 1, 0, 0, 0, 0, 1, 1, 0, 0, 0, 0, 1, 1,
                0, 0, 0, 0, 0, 0, 1, 1, 0, 1, 1, 1, 1, 1, 1, 1, 1, 1, 1, 0, 1,
                1, 0, 1, 1, 1, 1, 1, 1, 1, 1, 1, 1, 0, 1, 1, 1, 1, 1, 1, 1, 1,
                1, 1, 1, 1, 1, 1, 1, 1, 1, 1, 1, 1, 1, 1, 1, 1, 1, 1, 1, 1, 1
            ],
            "pacStart": 518,
            "ghostsMeta": [
                { "className": "blinky", "startIndex": 348, "speed": 95 },
                { "className": "pinky", "startIndex": 376, "speed": 140 },
                { "className": "inky", "startIndex": 351, "speed": 185 },
                { "className": "clyde", "startIndex": 379, "speed": 235 }
            ]
        },
        {
            "id": 2,
            "layout": [
                1, 1, 1, 1, 1, 1, 1, 1, 1, 1, 1, 1, 1, 1, 1, 1, 1, 1, 1, 1, 1,
                1, 1, 1, 1, 1, 1, 1, 1, 0, 0, 0, 0, 0, 0, 0, 0, 0, 0, 0, 0, 0,
                0, 0, 0, 0, 0, 0, 0, 0, 0, 0, 0, 0, 0, 1, 1, 0, 1, 1, 1, 1, 1,
                1, 1, 1, 1, 1, 1, 1, 1, 1, 1, 1, 1, 1, 1, 1, 1, 1, 1, 1, 0, 1,
                1, 0, 1, 3, 0, 0, 0, 0, 0, 0, 0, 0, 0, 1, 1, 0, 0, 0, 0, 0, 0,
                0, 0, 0, 3, 1, 0, 1, 1, 0, 1, 1, 1, 1, 0, 1, 1, 1, 1, 1, 0, 1,
                1, 0, 1, 1, 1, 1, 1, 0, 1, 1, 1, 1, 0, 1, 1, 0, 0, 0, 0, 1, 0,
                0, 0, 0, 0, 1, 0, 0, 0, 0, 0, 0, 0, 0, 0, 4, 0, 0, 0, 0, 0, 1,
                1, 0, 1, 1, 0, 1, 0, 1, 1, 1, 1, 1, 1, 1, 1, 1, 1, 1, 1, 1, 0,
                1, 0, 1, 1, 0, 1, 1, 1, 0, 1, 1, 0, 1, 0, 1, 1, 1, 1, 4, 4, 4,
                4, 4, 4, 4, 1, 1, 0, 1, 0, 1, 1, 0, 1, 1, 1, 0, 0, 0, 0, 1, 0,
                0, 0, 0, 0, 4, 1, 1, 4, 1, 1, 4, 0, 0, 0, 1, 0, 0, 0, 0, 0, 1,
                1, 1, 1, 1, 0, 1, 0, 1, 1, 1, 0, 4, 1, 2, 2, 2, 1, 4, 0, 1, 1,
                1, 0, 1, 1, 1, 1, 1, 1, 1, 1, 1, 0, 1, 0, 1, 1, 1, 0, 4, 4, 2,
                2, 2, 4, 4, 0, 1, 1, 1, 0, 1, 1, 1, 1, 1, 1, 1, 1, 1, 0, 0, 0,
                0, 0, 0, 0, 4, 1, 2, 2, 2, 1, 4, 0, 0, 0, 0, 0, 1, 1, 1, 1, 1,
                1, 1, 1, 1, 1, 1, 1, 1, 1, 1, 1, 4, 1, 2, 2, 2, 1, 4, 1, 1, 1,
                1, 1, 1, 1, 1, 1, 1, 4, 4, 4, 4, 4, 4, 4, 4, 4, 4, 4, 4, 1, 2,
                2, 2, 1, 4, 4, 4, 4, 4, 4, 4, 4, 4, 4, 4, 1, 1, 1, 1, 1, 1, 1,
                1, 1, 1, 1, 4, 1, 2, 2, 2, 1, 4, 1, 1, 1, 1, 1, 1, 1, 1, 1, 1,
                1, 0, 0, 0, 0, 0, 0, 0, 0, 0, 0, 4, 1, 2, 2, 2, 1, 4, 0, 0, 0,
                0, 0, 0, 0, 0, 0, 1, 1, 0, 1, 1, 1, 1, 1, 1, 1, 1, 0, 4, 1, 1,
                1, 1, 1, 4, 0, 1, 1, 1, 1, 1, 1, 1, 0, 1, 1, 0, 1, 1, 1, 1, 1,
                1, 1, 1, 0, 4, 4, 4, 4, 4, 4, 4, 0, 1, 1, 1, 1, 1, 1, 1, 0, 1,
                1, 0, 0, 0, 0, 0, 0, 0, 0, 1, 0, 0, 0, 0, 0, 0, 0, 0, 0, 1, 0,
                0, 0, 0, 0, 0, 0, 1, 1, 1, 1, 1, 1, 1, 1, 1, 0, 1, 1, 1, 1, 1,
                1, 1, 1, 1, 0, 1, 1, 1, 1, 1, 1, 1, 1, 1, 1, 0, 0, 0, 0, 0, 0,
                1, 0, 0, 0, 0, 0, 0, 0, 0, 0, 0, 0, 4, 0, 0, 0, 0, 0, 0, 0, 1,
                1, 0, 1, 1, 1, 1, 0, 1, 1, 1, 1, 1, 0, 1, 1, 0, 1, 1, 1, 1, 1,
                0, 1, 1, 1, 1, 0, 1, 1, 0, 1, 1, 1, 1, 0, 1, 1, 1, 1, 1, 0, 1,
                1, 0, 1, 1, 1, 1, 1, 0, 1, 1, 1, 1, 0, 1, 1, 3, 0, 0, 1, 1, 0,
                0, 0, 0, 0, 0, 0, 0, 0, 0, 0, 0, 0, 0, 0, 0, 1, 1, 0, 0, 3, 1,
                1, 1, 1, 0, 1, 1, 0, 1, 1, 0, 1, 1, 1, 1, 1, 1, 1, 1, 0, 1, 1,
                0, 1, 1, 0, 1, 1, 1, 1, 1, 1, 0, 1, 1, 0, 1, 1, 0, 1, 1, 1, 1,
                1, 1, 1, 1, 0, 1, 1, 0, 1, 1, 0, 1, 1, 1, 1, 1, 1, 1, 1, 1, 1,
                1, 1, 1, 1, 1, 1, 1, 1, 1, 1, 1, 1, 1, 1, 1, 1, 1, 1, 1, 1, 1
            ],
            "pacStart": 489,
            "ghostsMeta": [
                { "className": "blinky", "startIndex": 348, "speed": 90 },
                { "className": "pinky", "startIndex": 376, "speed": 130 },
                { "className": "inky", "startIndex": 351, "speed": 170 },
                { "className": "clyde", "startIndex": 379, "speed": 220 }
            ]
        },
        {
            "id": 3,
            "layout": [
                1, 1, 1, 1, 1, 1, 1, 1, 1, 1, 1, 1, 1, 1, 1, 1, 1, 1, 1, 1, 1,
                1, 1, 1, 1, 1, 1, 1, 1, 0, 0, 0, 0, 0, 0, 0, 0, 0, 0, 0, 0, 0,
                0, 0, 0, 0, 0, 0, 0, 0, 0, 0, 0, 0, 0, 1, 1, 0, 1, 1, 1, 1, 1,
                1, 1, 1, 1, 1, 1, 1, 1, 1, 1, 1, 1, 1, 1, 1, 1, 1, 1, 1, 0, 1,
                1, 0, 1, 3, 4, 4, 0, 0, 0, 0, 0, 0, 0, 1, 1, 0, 0, 0, 0, 0, 0,
                0, 0, 4, 3, 1, 0, 1, 1, 0, 1, 1, 1, 1, 0, 1, 1, 1, 1, 1, 0, 1,
                1, 0, 1, 1, 1, 1, 1, 0, 1, 1, 1, 1, 0, 1, 1, 0, 0, 0, 0, 1, 0,
                1, 1, 1, 1, 1, 0, 0, 0, 0, 0, 1, 1, 1, 0, 4, 0, 0, 0, 0, 0, 1,
                1, 1, 1, 1, 0, 1, 0, 1, 1, 4, 4, 4, 4, 1, 1, 1, 4, 4, 4, 1, 0,
                1, 0, 1, 1, 1, 1, 1, 1, 1, 1, 1, 0, 1, 0, 1, 1, 4, 1, 1, 1, 2,
                2, 1, 1, 1, 4, 1, 0, 1, 0, 1, 1, 1, 1, 1, 1, 0, 0, 0, 0, 1, 0,
                0, 0, 4, 1, 1, 1, 2, 2, 1, 1, 1, 4, 0, 0, 1, 0, 0, 0, 0, 0, 1,
                1, 0, 1, 1, 0, 1, 0, 1, 1, 4, 1, 1, 1, 2, 2, 1, 1, 1, 4, 1, 1,
                1, 0, 1, 1, 0, 1, 1, 1, 0, 1, 1, 0, 1, 0, 1, 1, 4, 4, 4, 4, 4,
                4, 4, 4, 4, 4, 1, 1, 1, 0, 1, 1, 0, 1, 1, 1, 0, 1, 1, 0, 0, 0,
                1, 1, 1, 1, 1, 1, 2, 2, 1, 1, 1, 1, 0, 0, 0, 0, 1, 1, 0, 1, 1,
                1, 0, 1, 1, 1, 1, 0, 1, 1, 1, 1, 1, 1, 2, 2, 1, 1, 1, 1, 1, 1,
                1, 0, 1, 1, 0, 1, 1, 4, 4, 4, 4, 4, 4, 0, 0, 0, 4, 4, 4, 4, 2,
                2, 4, 4, 4, 4, 0, 0, 0, 4, 4, 4, 4, 4, 4, 1, 1, 1, 1, 1, 1, 0,
                1, 1, 4, 1, 1, 1, 2, 2, 1, 1, 1, 4, 1, 1, 1, 0, 1, 1, 1, 1, 1,
                1, 0, 0, 0, 0, 0, 0, 1, 1, 4, 1, 1, 1, 2, 2, 1, 1, 1, 4, 1, 0,
                0, 0, 0, 0, 0, 0, 1, 1, 0, 1, 1, 1, 1, 0, 1, 1, 4, 1, 1, 1, 1,
                1, 1, 1, 1, 4, 1, 0, 1, 1, 1, 1, 1, 0, 1, 1, 0, 1, 1, 1, 1, 0,
                1, 1, 4, 4, 4, 4, 4, 4, 4, 4, 4, 4, 1, 0, 1, 1, 1, 1, 1, 0, 1,
                1, 0, 0, 0, 0, 0, 0, 0, 0, 0, 0, 0, 0, 0, 0, 0, 0, 0, 0, 0, 0,
                0, 0, 0, 0, 0, 0, 1, 1, 1, 1, 1, 4, 1, 1, 1, 1, 1, 1, 1, 1, 1,
                1, 1, 1, 1, 1, 1, 1, 1, 1, 4, 1, 1, 1, 1, 1, 0, 0, 0, 0, 0, 0,
                0, 0, 4, 0, 0, 0, 0, 0, 0, 0, 0, 4, 0, 0, 0, 0, 0, 0, 0, 0, 1,
                1, 0, 1, 1, 1, 1, 1, 1, 1, 4, 1, 1, 1, 1, 1, 1, 1, 1, 4, 1, 1,
                1, 1, 1, 1, 1, 0, 1, 1, 0, 1, 1, 1, 1, 1, 1, 1, 4, 1, 1, 1, 1,
                1, 1, 1, 1, 4, 1, 1, 1, 1, 1, 1, 1, 0, 1, 1, 3, 0, 0, 1, 1, 0,
                0, 0, 0, 0, 0, 0, 0, 0, 0, 0, 0, 0, 0, 0, 0, 1, 1, 0, 0, 3, 1,
                1, 1, 1, 0, 1, 1, 0, 1, 1, 0, 1, 1, 1, 1, 1, 1, 1, 1, 0, 1, 1,
                0, 1, 1, 0, 1, 1, 1, 1, 1, 1, 0, 1, 1, 0, 1, 1, 0, 1, 1, 1, 1,
                1, 1, 1, 1, 0, 1, 1, 0, 1, 1, 0, 1, 1, 1, 1, 0, 0, 0, 0, 0, 0,
                1, 1, 0, 0, 0, 0, 1, 1, 0, 0, 0, 0, 1, 1, 0, 0, 0, 0, 0, 0, 1,
                1, 1, 1, 1, 1, 1, 1, 1, 1, 1, 1, 1, 1, 1, 1, 1, 1, 1, 1, 1, 1,
                1, 1, 1, 1, 1, 1, 1
            ],
            "pacStart": 489,
            "ghostsMeta": [
                { "className": "blinky", "startIndex": 348, "speed": 85 },
                { "className": "pinky", "startIndex": 376, "speed": 125 },
                { "className": "inky", "startIndex": 351, "speed": 160 },
                { "className": "clyde", "startIndex": 379, "speed": 200 }
            ]
        }
    ]
}
